Stavanger	Western_Norway
Sotra	Western_Norway
Torvikbygd	Western_Norway
Sula	Western_Norway
Bjugn	Western_Norway
Frosta	Western_Norway
Rotterdam	North_Sea
Achterwasser	Baltic_Sea
Baltic_Southwest	Baltic_Sea
Rugen	Baltic_Sea
Salt_Meadows	Baltic_Sea
Arkona_Basin_East	Baltic_Sea
Arkona_Basin_West	Baltic_Sea
Fakse_Bugt	Baltic_Sea
Lubeck	Baltic_Sea
Kieler_Bucht	Baltic_Sea
Storebaelt	Baltic_Sea
Lillebaelt	Baltic_Sea
Samso_Belt	Baltic_Sea
Kattegat	Baltic_Sea
Treoa_Moellebugt	Baltic_Sea
Vendsyssel_Thy	Baltic_Sea
Laesoe	Baltic_Sea
Bohuslan	Baltic_Sea
Goteborg	Baltic_Sea
Halmstad	Baltic_Sea
Asa	Baltic_Sea
Sund	Baltic_Sea
Havang	Baltic_Sea
Blekinge	Baltic_Sea
Ustka	Baltic_Sea
West_Gulf_Of_Gdansk	Baltic_Sea
South_Vistula	Baltic_Sea
Curonian_Spit	Baltic_Sea
Lithuania	Baltic_Sea
Ventspils	Baltic_Sea
West_Gulf_Of_Riga	Baltic_Sea
Riga	Baltic_Sea
Parnu	Baltic_Sea
South_Saaremaa	Baltic_Sea
Hiiumaa	Baltic_Sea
Ostergotland	Baltic_Sea
Sodermanland	Baltic_Sea
Paldiski	Baltic_Sea
Tallinn	Baltic_Sea
Lahemaa	Baltic_Sea
Narva-Luga	Baltic_Sea
St_Petersburg	Baltic_Sea
Virolahti	Baltic_Sea
Porvoo	Baltic_Sea
Helsinki	Baltic_Sea
Salo	Baltic_Sea
Turku	Baltic_Sea
Aland	Baltic_Sea
Gastrikland	Baltic_Sea
Angermanland	Baltic_Sea
Alvsbyn	Baltic_Sea
Gunnarsbyn	Baltic_Sea
South_Lapland	Baltic_Sea
Oulu	Baltic_Sea
South_Ostrobothnia	Baltic_Sea
Satakunta	Baltic_Sea
Central_Finland	Baltic_Sea
Langeoog	North_Sea
Netherlands_Wadden_Sea	North_Sea
Belgium	North_Sea
Southern_Bight	North_Sea
Central_Netherlands	North_Sea
Oyster_Ground	North_Sea
