Cairns	Northeastern_Australia_(MIS3_-_MIS4)
Mackay	Northeastern_Australia_(MIS3_-_MIS4)
Huon_Peninsula	Papua_New_Guinea_(MIS3_-_MIS4)
US_Mid_Atlantic	Eastern_United_States_(MIS3_-_MIS4)
South_Bohai_Sea	Yellow_Sea_(MIS3_-_MIS4)
Yellow_Sea	Yellow_Sea_(MIS3_-_MIS4)
Mururoa	French_Polynesia_(MIS3_-_MIS4)
Tahiti	French_Polynesia_(MIS3_-_MIS4)
Sunda_Shelf	Sundaland_(MIS3_-_MIS4)
Vietnam_Shelf	Sundaland_(MIS3_-_MIS4)
Strait_Of_Malacca	Sundaland_(MIS3_-_MIS4)
Mekong_Delta	Sundaland_(MIS3_-_MIS4)
Chao_Phraya	Sundaland_(MIS3_-_MIS4)
Berhala_Strait	Sundaland_(MIS3_-_MIS4)
Tsushima-Korea_Strait	Sea_of_Japan_-_East_Sea_(MIS3_-_MIS4)
Huon_Peninsula_de_Gelder	Papua_New_Guinea_(MIS3_-_MIS4)
Vanuatu	Melanesia_(MIS3_-_MIS4)
Langhovde	East_Antarctica_(MIS3_-_MIS4)
Ongul_Islands	East_Antarctica_(MIS3_-_MIS4)
Rauer_Group	East_Antarctica_(MIS3_-_MIS4)
Larsemann_Hills	East_Antarctica_(MIS3_-_MIS4)
Kikaijima	Ryukyu_Islands_(MIS3_-_MIS4)
