Danmarks_Fjord	Northeast_Greenland	Danmarks_Fjord		
Frederick_E_Hyde_Fjord	Northeast_Greenland	Frederick_E_Hyde_Fjord		
Germania_Land	Northeast_Greenland	Germania_Land		
Hochstetter_Forland	Northeast_Greenland	Hochstetter_Forland		
Hold_With_Hope	Northeast_Greenland	Hold_With_Hope		
Independence_Fjord	Northeast_Greenland	Independence_Fjord		
JP_Koch_Fjord	Northeast_Greenland	JP_Koch_Fjord		
Jameson_Land	Northeast_Greenland	Jameson_Land		
Kap_Clarence_Wyckoff	Northeast_Greenland	Kap_Clarence_Wyckoff		
Kap_Morris_Jesup	Northeast_Greenland	Kap_Morris_Jesup		
Kempe_Fjord	Northeast_Greenland	Kempe_Fjord		
Kong_Oscar_Fjord	Northeast_Greenland	Kong_Oscar_Fjord		
Nansen_land	Northeast_Greenland	Nansen_land		
Nioghalvfjerdsfjorden	Northeast_Greenland	Nioghalvfjerdsfjorden		
Prinsesse_Ingeborg_Halvoe	Northeast_Greenland	Prinsesse_Ingeborg_Halvoe	Prinsesse Ingeborg Halvø	Prinsesse Ingeborg Halv\370
Renland	Northeast_Greenland	Renland		
Schuchert_Dal	Northeast_Greenland	Schuchert_Dal		
Traill_Oe	Northeast_Greenland	Traill_Oe	Traill Ø	Traill \330
Young_Sund	Northeast_Greenland	Young_Sund		
Bessel_Fjord	Northwest_Greenland	Bessel_Fjord		
Hall_Land	Northwest_Greenland	Hall_Land		
Inglefield_Fjord	Northwest_Greenland	Inglefield_Fjord		
Kangerluarsuk_Cass_Fjord	Northwest_Greenland	Kangerluarsuk_Cass_Fjord	Kangerluarsuk_(Cass_Fjord)	Kangerluarsuk_(Cass_Fjord)
Nordvestoe	Northwest_Greenland	Nordvestoe	Nordvestø	Nordvest\370
Thule	Northwest_Greenland	Thule		
Tuttulissuaq	Northwest_Greenland	Tuttulissuaq		
Warming_Land	Northwest_Greenland	Warming_Land		
Wulff_land	Northwest_Greenland	Wulff_land		
Ammassalik	Southeast_Greenland	Ammassalik		
Akulliit	Southwest_Greenland	Akulliit		
Alluttoq_Island	Southwest_Greenland	Alluttoq_Island		
Eqalussuit_Tasiat	Southwest_Greenland	Eqalussuit_Tasiat		
Ikertooq_Fjord	Southwest_Greenland	Ikertooq_Fjord		
Ilulissat	Southwest_Greenland	Ilulissat		
Itilleq	Southwest_Greenland	Itilleq		
Kangerluk	Southwest_Greenland	Kangerluk		
Kangerlussuaq	Southwest_Greenland	Kangerlussuaq		
Kannala	Southwest_Greenland	Kannala		
Kapisillit	Southwest_Greenland	Kapisillit		
Maniitsoq	Southwest_Greenland	Maniitsoq		
Nanortalik	Southwest_Greenland	Nanortalik		
Nuuk	Southwest_Greenland	Nuuk		
Paamiut	Southwest_Greenland	Paamiut		
Qaqortoq	Southwest_Greenland	Qaqortoq		
Qeqertarsuatsiaat	Southwest_Greenland	Qeqertarsuatsiaat		
Sisimiut	Southwest_Greenland	Sisimiut		
Tasiussarsuaq	Southwest_Greenland	Tasiussarsuaq		
