Abruzzo	Adriatic_Sea	Abruzzo		
Northeastern_Adriatic_Sea	Adriatic_Sea	Northeastern_Adriatic_Sea		
Northwestern_Adriatic_Sea	Adriatic_Sea	Northwestern_Adriatic_Sea		
Venice	Adriatic_Sea	Venice		
Vis	Adriatic_Sea	Vis		
East_Sicily	Central_Mediterranean	East_Sicily		
Malta_-_South_Sicily	Central_Mediterranean	Malta_-_South_Sicily		
Southern_Tunisia	Central_Mediterranean	Southern_Tunisia		
Balearic_Islands	Western_Mediterranean	Balearic_Islands		
Camargue	Western_Mediterranean	Camargue		
Catalonia	Western_Mediterranean	Catalonia		
East_Corsica	Western_Mediterranean	East_Corsica		
East_Sardinia	Western_Mediterranean	East_Sardinia		
French_Riviera	Western_Mediterranean	French_Riviera		
Gulf_of_Gaeta	Western_Mediterranean	Gulf_of_Gaeta		
Gulf_of_Salerno	Western_Mediterranean	Gulf_of_Salerno		
Gulf_of_Valencia	Western_Mediterranean	Gulf_of_Valencia		
Lazio	Western_Mediterranean	Lazio		
Liguria	Western_Mediterranean	Liguria		
Strait_of_Bonifacio	Western_Mediterranean	Strait_of_Bonifacio		
Tuscany	Western_Mediterranean	Tuscany		
West_Corsica	Western_Mediterranean	West_Corsica		
West_Sardinia	Western_Mediterranean	West_Sardinia		
Western_Sicily	Western_Mediterranean	Western_Sicily		
